R                              1800                           720    
NO ./imgs/hitler.xpm
			 
SO ./imgs/grey.xpm
WE ./imgs/eagle.xpm
EA ./imgs/grey.xpms

S ./imgs/chest.xpm    

F 224,172,105   
C 205,249,255  

        1111111111111111111111111
        1000000000110000000000001
        1011000001110000002000001
        1001000000000000000000001
111111111011000001110000000000001
100000000011000001111111111111111
11110111111111011100000010001
11110111111111010101010010001
11000000110101011100000012001
100020000000000011000E0000001
10000000000000001101010010001
11000001110101011111011112211
11110111 1110101 101111010201
11111111 1111111 111111111111